julianmacleod	yvonnemorrison,gavinskinner,yvonneross,vanessapaterson,janewallace
yvonnemorrison	julianmacleod
gavinskinner	julianmacleod
yvonneross	julianmacleod
vanessapaterson	julianmacleod
janewallace	julianmacleod
maryturner	connorhodges,timdyer,neilrobertson,sueduncan,angelamay
connorhodges	maryturner
timdyer	maryturner
neilrobertson	maryturner
sueduncan	maryturner
angelamay	maryturner
jonathanallan	rachelrobertson,stewartbutler,colinwatson,faithbuckland
rachelrobertson	jonathanallan
stewartbutler	jonathanallan
colinwatson	jonathanallan
faithbuckland	jonathanallan
gordonbutler	robertspringer,emmamclean,ruthgraham,faithlawrence,jakeslater
robertspringer	gordonbutler
emmamclean	gordonbutler
ruthgraham	gordonbutler
faithlawrence	gordonbutler
jakeslater	gordonbutler
ianrees	austinmackenzie,stephanieellison,philburgess,oliverbuckland
austinmackenzie	ianrees
stephanieellison	ianrees
philburgess	ianrees
oliverbuckland	ianrees
paulstewart	annamacleod,richardcarr,amandaball,joanjohnston,charleshardacre
annamacleod	paulstewart
richardcarr	paulstewart
amandaball	paulstewart
joanjohnston	paulstewart
charleshardacre	paulstewart
